     

        #########          ############             ##########
        #                        #			#
	#                        #			#
	#                        #                      #
	#####                    #                      #
	#                        #                      #
	#                        #                      #
	#                        #                      #
	#                       ##########                 #






       ####################################################                      