########################################################
#                 
#
#
#                            ###########################
# #
#                                                 ########
#                                                        #
#              
#                          #
#                          #
#                          ##########
                                         
